# Syntax Coloring Map For BMDBLEController

# Classes (KEYWORD1)
BMDBLEController	KEYWORD1
PinInputInterface	KEYWORD1
CallbackInterface	KEYWORD1
BLEConnectionManager	KEYWORD1
BondingManager	KEYWORD1
LensControl	KEYWORD1
VideoControl	KEYWORD1
AudioControl	KEYWORD1
TransportControl	KEYWORD1
SerialPinInputMethod	KEYWORD1
DefaultPinInputMethod	KEYWORD1
TimecodeManager	KEYWORD1

# Methods and Functions (KEYWORD2)
begin	KEYWORD2
end	KEYWORD2
connect	KEYWORD2
disconnect	KEYWORD2
isConnected	KEYWORD2
isBonded	KEYWORD2
startScan	KEYWORD2
stopScan	KEYWORD2
isScanning	KEYWORD2

# High-level convenience methods
setWhiteBalance	KEYWORD2
setISO	KEYWORD2
setShutterAngle	KEYWORD2
setShutterSpeed	KEYWORD2
setFocus	KEYWORD2
setZoom	KEYWORD2
setAperture	KEYWORD2
setAutoFocus	KEYWORD2
getWhiteBalance	KEYWORD2
getISO	KEYWORD2
getShutterAngle	KEYWORD2
getShutterSpeed	KEYWORD2
getFocus	KEYWORD2
getZoom	KEYWORD2
getAperture	KEYWORD2
startRecording	KEYWORD2
stopRecording	KEYWORD2
isRecording	KEYWORD2
setDynamicRangeValue	KEYWORD2
getDynamicRangeValue	KEYWORD2

# FPS and Timecode methods
getFPS	KEYWORD2
setFPS	KEYWORD2
getTimecode	KEYWORD2
getTimecodeHours	KEYWORD2
getTimecodeMinutes	KEYWORD2
getTimecodeSeconds	KEYWORD2
getTimecodeFrames	KEYWORD2
getRawTimecodeData	KEYWORD2
getTimecodeString	KEYWORD2
setTimecodeCallback	KEYWORD2

# Generic raw parameter access methods
sendCommand	KEYWORD2
sendRawCommand	KEYWORD2
requestParameterByID	KEYWORD2
setParameterByID	KEYWORD2
setParameterInt8	KEYWORD2
setParameterInt16	KEYWORD2
setParameterInt32	KEYWORD2
setParameterFixed16	KEYWORD2
setParameterString	KEYWORD2
getParameterByID	KEYWORD2
getParameterInt8	KEYWORD2
getParameterInt16	KEYWORD2
getParameterInt32	KEYWORD2
getParameterFixed16	KEYWORD2
getParameterString	KEYWORD2
getParameterRaw	KEYWORD2
getRawParameterData	KEYWORD2
getLastPacket	KEYWORD2
hasParameter	KEYWORD2

# Callback methods
setConnectionCallback	KEYWORD2
setParameterCallback	KEYWORD2
setRawParameterCallback	KEYWORD2
setAllPacketsCallback	KEYWORD2
setErrorCallback	KEYWORD2
setPinInputMethod	KEYWORD2
clearBondingInformation	KEYWORD2
getErrorMessage	KEYWORD2
getLastError	KEYWORD2

# Constants (LITERAL1)
BMD_CAT_LENS	LITERAL1
BMD_CAT_VIDEO	LITERAL1
BMD_CAT_AUDIO	LITERAL1
BMD_CAT_OUTPUT	LITERAL1
BMD_CAT_DISPLAY	LITERAL1
BMD_CAT_TALLY	LITERAL1
BMD_CAT_REFERENCE	LITERAL1
BMD_CAT_CONFIG	LITERAL1
BMD_CAT_COLOR	LITERAL1
BMD_CAT_STATUS	LITERAL1
BMD_CAT_TRANSPORT	LITERAL1
BMD_CAT_EXTENDED_LENS	LITERAL1

BMD_PARAM_FOCUS	LITERAL1
BMD_PARAM_APERTURE_FSTOP	LITERAL1
BMD_PARAM_APERTURE_NORM	LITERAL1
BMD_PARAM_AUTO_APERTURE	LITERAL1
BMD_PARAM_ZOOM_MM	LITERAL1
BMD_PARAM_ZOOM_NORM	LITERAL1
BMD_PARAM_WB	LITERAL1
BMD_PARAM_ISO	LITERAL1
BMD_PARAM_SHUTTER_ANGLE	LITERAL1
BMD_PARAM_SHUTTER_SPEED	LITERAL1
BMD_PARAM_GAIN	LITERAL1
BMD_PARAM_DYNAMIC_RANGE	LITERAL1
BMD_PARAM_RECORDING	LITERAL1

BMD_OP_ASSIGN	LITERAL1
BMD_OP_OFFSET	LITERAL1
BMD_OP_REPORT	LITERAL1

BMD_TYPE_VOID	LITERAL1
BMD_TYPE_BYTE	LITERAL1
BMD_TYPE_INT16	LITERAL1
BMD_TYPE_INT32	LITERAL1
BMD_TYPE_INT64	LITERAL1
BMD_TYPE_STRING	LITERAL1
BMD_TYPE_FIXED16	LITERAL1

BMD_ERROR_NONE	LITERAL1
BMD_ERROR_NOT_CONNECTED	LITERAL1
BMD_ERROR_NOT_BONDED	LITERAL1
BMD_ERROR_CONNECTION_FAILED	LITERAL1
BMD_ERROR_PIN_ENTRY_FAILED	LITERAL1
BMD_ERROR_COMMAND_FAILED	LITERAL1
BMD_ERROR_INVALID_PARAMETER	LITERAL1

BMD_DYNAMIC_RANGE_FILM	LITERAL1
BMD_DYNAMIC_RANGE_VIDEO	LITERAL1
BMD_DYNAMIC_RANGE_EXTENDED	LITERAL1
